111111111111111
1P0001100000C01
111001000X11101
110100000X11101
100000000X11101
111100000X111E1
111111111111111