11111111111111111
10010000C1X100011
10100111011000011
10P011E0000000011
10101110000000011
11111111111111111