1111111111111111
10010000C0XC0001
1000011101000001
10P011E000000001
1000111000000001
1111111111111111