1111111111111
10010000C0XC1
1000011101001
100P11E000001
1111111111111